44
26
********************************************
*                     *                    *
*      *      ****    *                    *
*      *         *                         *
*      *         *        **********       *
*      *         *            **           *
*      *         *            **           *
*                             **           *
*                             **           *
*  *********    ***    ***    **           *
*  *********    *        *                 *
*         **    *        *       ********  *
*         **        **           ********  *
*         **       ****          **        *
*                   **           **        *
*               *        *       **        *
*********       *        *                 *
*               ***    ***                 *
*                          *********       *
*    *               *                     *
*    *              *****                  *
*    *      **      *   **         ****    *
*    *       **          *      *********  *
*    *        **              *****        *
*              **                          *
********************************************