44
26
********************************************
*                                          *
*      *      ****                         *
*      *         *                         *
*      *         *        **********       *
*      *         *            **           *
*      *         *            **           *
*                *            **           *
*               *             **           *
*  *************              **           *
*  *********        **                     *
*         **        **           ********  *
*         **                     ********  *
*         **                     **        *
*                                **        *
*                   *******      **        *
*********           *******                *
*                   *******                *
*                   ****************       *
*    *              *******                *
*    *              *******                *
*    *      **                     ****    *
*    *       **                 *********  *
*    *        **              *****        *
*              **                          *
********************************************