44
26
********************************************
*                     *                    *
*      *              *                    *
*      *       *                           *
*      *      **          **********       *
*      *      *               **           *
*      *                      **           *
*                             **           *
*               ***    ***    **           *
*  *********    *        *    **           *
*  *********    *        *                 *
*         **        **           ********  *
*         **       ****          ********  *
*         **       ****          **        *
*                   **           **        *
*               *        *       **        *
*********       *        *                 *
*               ***    ***                 *
*                            *******       *
*    *               *                     *
*    *              *****                  *
*    *      **      *   **         ****    *
*    *       **          *      *********  *
*    *        **              *****        *
*              **                          *
********************************************