43
25
*******************************************
*     *     * *   *             *       * *
* * ******* * * * * * ***** *** * ***** * *
* *   *       * *     * *     *       * * *
* * * * ***** * * *** * *** * * ***** * * *
*   *     *   *       *     *   *     *   *
*** * *** * * *** *** * * *** * *** * * ***
*   *   *     *   *   * *     *     * *   *
* * *** ***** * * * *** * * *** ***** *** *
* *             * * *   * *   *       *   *
* ***** *** *** * * *** * * * ***** * * ***
*     * *     *     *     * *       *   * *
***** * * ********* ***** * *** *** *** * *
*   *   *   *     *     *   *   *         *
* ***** *** * *** * * * * * *** *** * *****
*       *   * *     *   *       *   * *   *
*** *** * *** * * * * ***** * *** * * * * *
*         *     * *     *   *   * *     * *
*** ***** * * *** * *** * * * * *** *** * *
*   *         *   *     * *   *     * * * *
* * * * * *** * *** * *** * * ***** * * * *
*     * *   *       *       * *       * * *
***** * *** * ***** * ***** * * *** *** * *
*       *      *      *           *       *
*******************************************