43
25
*******************************************
*     *     * *   *             *       * *
* * ******* * * * * * ***** *** * ***** * *
* *   *       * *     * *     *       * * *
* * * * ***** * * *** * *** * * ***** * * *
*   *     *           *     *   *     *   *
*** * *** * * *** *** * * *** * *** * * ***
*   *   *     *   *     *     *     * *   *
* * *** ***** * * * *** * * *** ***** *** *
* *             * * *   * *   *       *   *
* ***** *** *** * * *** * * * ***** * * ***
*     * *     *     *     * *       *   * *
*** * * * *** ***** * *** * *** * * *** * *
*   *   *         *     *   *   *         *
* ***** *** * *** * * * * * *** *** * *****
*           * *     *   *       *   * *   *
*** *** * *** * * * * ***** * *** * * * * *
*         *     * *         *     *     * *
*** ***** * * *** * *** * * * * *** *** * *
*   *         *   *     * *   *     * * * *
* * * * * *** * *** * *** * * ***** * * * *
*     * *   *       *       * *       * * *
***** * * * * ***** * ***** * * *** *** * *
*       *      *      *           *       *
*******************************************