10
10
**********
*    *****
*    *** *
*    **  *
*    *   *
*****    *
****     *
***      *
**       *
**********