41
10
*****************************************
****************    P    ****************
*****************************************
*                                       *
*                                       *
*                                       *
*                                       *
*                                       *
*                                       *
*****************************************